11 11 11 22 13 12 21 11 11 11 11 11 11 11 11 11 11 11 11 11 11 11 11 11 11 11 11 11 11 11 11 11 11 11 11 22 12 13 21 11 11 11
11 11 11 22 13 12 21 11 11 11 11 11 11 11 11 11 11 11 11 11 11 11 11 11 11 11 11 11 11 11 11 11 11 11 11 22 12 13 21 11 11 11
11 11 11 22 13 12 21 11 11 11 11 11 11 11 11 11 11 11 11 11 11 11 11 11 11 11 11 11 11 11 11 11 11 11 11 22 12 13 21 11 11 11
11 11 11 22 13 12 12 19 19 19 19 19 19 19 19 19 19 19 19 19 19 19 19 19 19 19 19 19 19 19 19 19 19 19 19 12 12 13 21 11 11 11
11 11 11 22 13 12 12 13 13 13 13 13 13 13 13 13 13 13 13 13 13 13 13 13 13 13 13 13 13 13 13 13 13 13 13 12 12 13 21 11 11 11
11 11 11 22 13 12 12 12 12 12 12 12 12 12 12 12 12 12 12 12 12 12 12 12 12 12 12 12 12 12 12 12 12 12 12 12 12 13 21 11 11 11
11 11 11 22 13 12 12 12 12 12 12 12 12 12 12 12 12 12 12 12 12 12 12 12 12 12 12 12 12 12 12 12 12 12 12 12 12 13 21 11 11 11
11 11 11 22 13 12 12 10 10 10 10 13 13 13 13 10 10 10 10 10 10 10 10 13 13 13 13 10 10 10 13 10 10 13 10 12 12 13 21 11 11 11
11 11 11 22 13 12 12 10 10 10 10 10 10 10 10 10 10 10 10 10 10 10 10 10 10 10 10 10 10 10 10 10 10 10 10 12 12 13 21 11 11 11
11 11 11 22 13 12 12 10 13 13 10 10 10 13 13 10 10 10 10 10 10 10 10 13 13 10 10 13 13 10 10 13 13 10 10 12 12 13 21 11 11 11
11 11 11 22 13 12 12 10 10 10 10 10 10 13 13 10 10 13 13 10 10 10 10 13 13 10 10 13 13 10 10 13 13 10 10 12 12 13 21 11 11 11
11 11 11 22 13 12 12 10 13 13 10 10 10 13 13 10 10 10 10 13 13 10 10 10 10 10 10 10 10 10 10 10 10 10 10 12 12 13 21 11 11 11
11 11 11 22 13 12 12 10 10 10 10 10 10 10 10 10 10 10 10 10 10 13 13 10 10 10 10 10 13 13 13 10 10 10 10 12 12 13 21 11 11 11
11 11 11 22 13 12 12 10 13 13 10 10 10 10 10 10 10 10 10 10 10 10 10 10 10 10 10 10 10 10 13 10 10 10 10 12 12 13 21 11 11 11
11 11 11 22 13 12 12 10 10 10 10 10 10 10 10 10 13 13 10 10 10 10 13 13 10 10 10 10 10 10 13 10 10 10 10 12 12 13 21 11 11 11
11 11 11 22 13 12 12 10 10 10 10 10 10 10 10 10 10 10 10 10 10 10 10 10 10 10 10 10 10 10 13 10 10 10 10 12 12 13 21 11 11 11
11 11 11 22 13 12 12 10 10 13 13 10 10 20 20 20 20 20 20 20 20 20 10 10 10 10 10 10 10 10 10 10 13 10 10 12 12 13 21 11 11 11
11 11 11 22 13 12 12 10 10 10 13 10 21 11 11 11 11 11 11 11 11 11 22 10 10 13 13 10 10 10 10 10 13 10 10 12 12 13 21 11 11 11
11 11 11 22 13 12 12 10 10 10 13 10 10 19 19 19 19 19 19 19 19 19 10 10 10 10 10 10 10 10 10 10 13 10 10 12 12 13 21 11 11 11
11 11 11 22 13 12 12 10 10 10 13 10 10 10 13 13 13 13 13 13 10 10 10 10 10 10 10 10 10 10 10 13 10 10 10 12 12 13 21 11 11 11
11 11 11 22 13 12 12 10 10 10 13 10 10 10 13 13 13 13 13 13 10 10 10 10 13 13 13 10 10 10 10 13 10 10 10 12 12 13 21 11 11 11
11 11 11 22 13 12 12 10 10 10 10 10 10 10 13 13 13 13 13 13 10 10 10 10 10 10 10 10 10 10 10 10 10 13 10 12 12 13 21 11 11 11
11 11 11 22 13 12 12 10 10 10 10 10 10 10 10 10 10 10 10 10 10 10 10 10 10 10 20 20 10 10 10 13 10 10 10 12 12 13 21 11 11 11
11 11 11 22 13 12 12 10 10 13 13 10 10 10 10 10 10 10 10 10 10 10 10 10 10 21 11 11 22 10 10 13 10 13 10 12 12 13 21 11 11 11
11 11 11 22 13 12 12 10 10 13 13 10 10 10 10 10 10 10 10 10 10 10 10 10 10 21 11 11 22 10 10 10 10 10 10 12 12 13 21 11 11 11
11 11 11 22 13 12 12 10 10 10 10 10 10 10 10 10 20 20 20 20 20 20 10 10 10 21 11 11 22 10 10 10 10 10 10 12 12 13 21 11 11 11
11 11 11 22 13 12 12 10 10 10 10 10 13 13 10 21 11 11 11 11 11 11 22 10 10 10 19 19 10 10 13 13 13 13 13 12 12 13 21 11 11 11
11 11 11 22 13 12 12 10 10 10 10 10 10 10 10 10 19 19 19 19 19 19 10 10 10 10 10 10 10 13 13 13 13 13 13 12 12 13 21 11 11 11
11 11 11 22 13 12 12 10 10 10 10 10 10 10 10 10 10 10 10 10 10 10 10 10 10 10 13 13 13 13 13 13 10 10 10 12 12 13 21 11 11 11
11 11 11 22 13 12 12 10 10 13 13 10 10 10 13 13 10 10 10 10 10 10 10 10 10 10 10 10 10 10 10 10 10 10 10 12 12 13 21 11 11 11
11 11 11 22 13 12 12 10 10 10 10 10 10 10 10 10 10 10 10 13 13 10 10 10 10 10 10 10 10 10 10 10 10 10 10 12 12 13 21 11 11 11
11 11 11 22 13 12 12 10 10 10 13 13 10 10 10 10 13 13 10 10 10 10 10 13 13 10 10 10 10 10 10 10 10 10 10 12 12 13 21 11 11 11
11 11 11 22 13 12 12 10 10 10 10 10 10 13 13 10 10 10 10 10 10 10 10 10 10 10 10 10 10 10 10 10 10 10 10 12 12 13 21 11 11 11
11 11 11 22 13 12 12 10 10 10 10 10 10 10 10 10 10 10 10 10 10 10 10 10 10 10 10 10 10 13 13 10 10 10 10 12 12 13 21 11 11 11
11 11 11 22 13 12 12 10 13 13 10 10 10 10 13 13 10 10 10 10 10 13 13 10 10 10 10 13 13 10 10 10 10 10 10 12 12 13 21 11 11 11
11 11 11 22 13 12 12 12 12 12 12 12 12 12 12 12 12 12 12 12 12 12 12 12 12 12 12 12 12 12 12 12 12 12 12 12 12 13 21 11 11 11
11 11 11 22 13 12 12 12 12 12 12 12 12 12 12 12 12 12 12 12 12 12 12 12 12 12 12 12 12 12 12 12 12 12 12 12 12 13 21 11 11 11
11 11 11 22 13 12 12 13 13 13 13 13 13 13 13 13 13 13 13 13 13 13 13 13 13 13 13 13 13 13 13 13 13 13 13 12 12 13 21 11 11 11
11 11 11 22 13 12 12 20 20 20 20 20 20 20 20 20 20 20 20 20 20 20 20 20 20 20 20 20 20 20 20 20 20 20 20 12 12 13 21 11 11 11
11 11 11 22 13 12 21 11 11 11 11 11 11 11 11 11 11 11 11 11 11 11 11 11 11 11 11 11 11 11 11 11 11 11 11 22 12 13 21 11 11 11
11 11 11 22 13 12 21 11 11 11 11 11 11 11 11 11 11 11 11 11 11 11 11 11 11 11 11 11 11 11 11 11 11 11 11 22 12 13 21 11 11 11
11 11 11 22 13 12 21 11 11 11 11 11 11 11 11 11 11 11 11 11 11 11 11 11 11 11 11 11 11 11 11 11 11 11 11 22 12 13 21 11 11 11


